参考资料	《建水方言志》《云南方言调查报告》
方言点	云南省红河州建水县临安镇
方言归属	西南官话－云南片－滇南小片
调值	①阴平44②阳平53③上声33④去声212
	̈ɿᵊ
tsɿ ᵊ	①知蜘支枝肢栀资姿脂兹滋之芝这②置汁姪侄质直植脊(～背)③紫纸只姊旨指止址子④自致至字痔治志痣炙蔗
tsʰɿ ᵊ	①雌疵痴嗤此②池驰瓷餐迟慈磁辞词祠持吃③此耻齿④刺赐翅次秩（～序)
sɿ ᵊ	①斯撕施私师狮尸司丝思诗匙（钥～）②矢时湿十拾什实失室适！(～合)③死屎使史驶始④是氏四肆示视嗜似祀已伺寺嗣饲士仕柿事市试侍豉（豆～）适（合～）
zᵊ	②日入（白）
	ɨ
pɨ	①屄②鼻别笔鳖毕必笔(～米汤)荸（～荠）③彼比秕（～谷子)④蔽弊币毙蓖闭辟备被
pʰɨ	①批披匹坯（打～子）②皮疲脾譬（～如)琵枇痹撇（一～一捺）辟僻③鄙撇（～开）④屁
mɨ	①咪眯微（白）②迷弥篾眉没（白）祕秘（一书；～鲁）灭密蜜③米④谜
tɨ	①爹低②叠碟蝶敌滴扚（～头发)的（目～）③底抵④弟第帝地
tʰɨ	①梯剔屉（抽～）②堤提题蹄啼帖贴铁场③体④涕剃替递
nɨ	①的（白）②尼泥呢倪宜谊疑聂镊业捏孽③你女④腻恁
lɨ	①哩②犁梨黎离(～别)璃厘驴猎立粒列烈裂劣栗律③旅礼李里理鲤屦④虑滤例厉励丽隶荔离2（一开一寸)利莉吏
tɕɨ	①居车拘驹鸡稽企（～业)饥肌基几机俱这（白）家（白）②接捷劫集辑急及级杰揭节截即鲫结洁吉绝蕨(～菜)决决疾橘积跡绩菊局脊(～梁骨)③姐举矩挤几（～个人)已纪④借巨拒距锯句具祭际挤剂计继技妓寄记忌季系（～鞋带)
tɕʰɨ	①蛆趋区驱妻欺期骏（黑～）②茄渠瞿齐脐骑歧祁其棋妾切缺七漆膝讫气曲麯③起启岂且取娶④弃契砌器气汽趣荠去（文）
ɕɨ	①些靴虚嘘顺需吁（喘～～）西犀溪栖嘻熙希稀携下（地～）②邪斜徐胁协习袭吸薛歇歇楔雪血穴悉恤昔惜席夕息媳熄锡析色（白）荨（～麻）③写小(～儿；～老二)许洗喜④泻卸谢序叙绪絮细系（关～）戏泄
ʑɨ	①耶迂（人很～）伊医衣依曰②鱼渔于余娱於盂俞渝愉移夷姨饴遗叶页揖（作～)悦月越粤乙一逸噎③也野语与雨宇禹羽椅已以里（～头）④夜御誉予遇寓芋喻裕艺义仪蚁议易异毅玉肆冀翼
	ɯ
pɯ	②不③补捕④部簿布布怖步
pʰɯ	①铺（～设)潽（饭～了）②菩认勃渤朴扑仆卜③脯蒲普谱浦④铺
mɯ	②木目牧穆模③母拇④茂贸
fɯ	①夫肤麸敷②符扶孵佛拂福幅蝠复腹服伏茯③府腑俯抚腐辅斧④父付赋傅附妇负富副赴
vɯ	①乌污巫②吴蜈吾悟杌（马～）物屋③五伍午武舞侮鹉④误悟恶（可～）务雾戍
tɯ	①都(～市)②独读督毒③堵赌肚（猪～）④杜肚(～子疼)妒度渡镀
tʰɯ	②徒屠途涂图突秃③土吐（一痰）④吐（呕～)兔
nɯ	①囡②奴驽③努弩④怒
ǀɯ	①撸②卢炉芦鸬庐鹿禄绿录③鲁掳(～松毛)橹虏卤④路露鹭
tsɯ	①租猪朱蛛珠硃中（人～）②卒浊捉（～猫～人）术（白～)竹筑逐轴祝足烛触蜀属嘱局菊③祖组阻煮主帚④助拄注驻住注蛀铸
tsʰɯ	①粗初(～中)②除锄出族曲畜(～牲)③楚礎杵处（相～)暑鼠拄(～拐棍)④醋处（所）
sɯ	①苏稣梳疏蔬书舒输殊②续戍旭术(～手)述速束肃宿叔淑宿（～舍)栗俗赎属戍③数（～一～)署④数(～目)素诉庶恕竖树塑漱
zɯ	①擩②如入狱欲浴域肉郁育疫辱褥③汝乳儒④儒(～家)
kɯ	①姑孤箍(～桶)锅(～巴)②谷骨③古估牯股鼓盤(～子)④顾故固雇
kʰɯ	①枯②酷哭窟③苦④裤库
xɯ	①呼乎②胡湖糊葫狐壶忽核（果子～）③虎浒④户互护沪
	ɐ
pɐ	①拜③摆④拜败稗
pʰɐ	②牌排③口（两臂左右平伸，两手之间的距离）④派
mɐ	②埋③买④卖
tɐ	①呆③逮歹④待代贷袋带戴载(～重量)
tʰɐ	①胎苔②抬台④泰态太
nɐ	①奶（阿～）③奶乃④耐奈
lɐ	②来③咧（龇牙～嘴）④癞赖
tsɐ	①灾栽斋③宰④在再债寨(～子)
tsʰɐ	①猜钗差（出～)②才材财裁柴豺③採采睬④菜蔡
sɐ	①腮鳃筛④赛晒
kɐ	①该阶街③改解（～开)④盖丐介界戒械届
kʰɐ	①开揩(～干净)③楷凯④概
xɐ	①㰩（篾制的扑蜻蜒用的器具）②孩鞋还（～有)③海蟹④亥害解（姓）
ɣɐ	①唉挨哀②岩捱磑崖③矮蔼④爱艾碍隘
	uɐ
kuɐ	①乖③柺拐（说～了)④怪
kʰuɐ	③块蒯④快筷会（～计)刽(～子手)
xuɐ	②怀淮槐④坏
uɐ	①歪③崴④外
tʃuɐ	③拽④跩
t̠ʃʰuɐ	①揣（～进去)③揣（～摸)④口（恶）
ʃuɐ	①衰③甩④帅
	ɑ
pɑ	①包胞③保宝饱堡④报抱菢（鸡打～）铇雹（冰～）豹暴爆
pʰɑ	①泡（松～)抛②刨袍跑④炮泡（～在水里)
mɑ	①猫毛(～驴)②毛矛茅锚③卯铆④冒帽貌
tɑ	①刀叨③祷岛倒（颠～）④道导稻到倒（～水)盗
tʰɑ	①滔掏萄（葡～）②桃逃淘陶涛③讨④套
nɑ	③脑恼④闹
lɑ	①捞②捞（打～)劳唠牢③老④涝落（莲花）
tsɑ	①遭糟朝（今～）昭招②着(～了)③早找枣蚤澡④皂灶赵罩召照兆诏
tsʰɑ	①操抄钞超②曹槽巢朝(～代)潮③草騲（～马）吵炒④造糙燥躁耖（翻整）觘（狗～的，～人）
sɑ	①骚稍烧捎稍②韶③扫(～地)嫂少（多～)④潲绍邵扫(～帚)少(～年)哨
zɑ	②饶③扰绕（围～）④绕
kɑ	①高膏糕羔③搞镐④告
kʰɑ	①敲③考烤④靠
xɑ	①蒿薅②毫豪壕嚎③好（～坏)④耗号好（爱～）
ɣɑ	①熬（药)②熬③襖④傲奥懊
	iɑ
piɑ	①标彪膘③表婊④嫑
pʰiɑ	①飘鳔②瓢嫖③熛（火～头发）④票漂(～衣裳)
miɑ	①喵猫（白）②瞄苗描③秒渺④庙妙
tiɑ	①刁叼貂雕③屌（蛋）④钓吊掉调（～动)
tʰiɑ	①挑②条调（～和）③调（～头）④跳
niɑ	③鸟④尿（文）
liɑ	②聊疗燎③了(～结)④料廖
tɕiɑ	①交郊胶教(～书)焦蕉椒骄娇浇②嚼(～筋：小气)③绞狡饺搅剿缴矫④轿叫教（～育)觉（睡）
tɕʰiɑ	①跷翘②瞧桥乔③巧④俏窍撬
ɕiɑ	①肖消销宵霄硝箫萧嚣③小（大～)晓④笑孝效校（学～，～对）酵
ʑiɑ	①夭妖邀腰要(～求)幺（～二三)吆②肴摇谣窑姚尧③咬舀④要（重～）耀跃
	ɔ
pɔ	①巴疤芭扒（用手～)②八拔爸③把（一～刀）㞎（屎～～）④霸把（刀～)坝耙罢
pʰɔ	①琶杷钯爬趴②爬扒(～手)④怕帕
mɔ	①妈蟆（癞蛤～）②麻抹(～布)③马码④骂
fɔ	②发罚伐法
vɔ	②袜
tɔ	②答搭打（一～）达③打④大
tʰɔ	①耷（垂下：～耳朵）他（文）②踏塔塌
nɔ	②拿纳④捺
ǀɔ	①拉②辣腊蜡瘌
tsɔ	①楂渣奓(～开嘴)碴②杂眨扎铡炸(～油条)闸轧③拃（一～长）鲊(～肉)④诈榨炸（爆～）乍
tsʰɔ	①叉杈差(～别)②茶搽查插察擦③岔(～巴：爱岔嘴的人)嚓④岔
sɔ	①沙纱杉(～树，～木)萨（菩～）山（～药）②杀撒(～尿)③洒厦（偏～）④撒(～谷壳)
kɔ	①伽③朒④尬
kʰɔ	①拤咖③卡
xɔ	①哈呵（打～欠）②蛤（獭～蟆）④下（打一～；那～）
ɔ	①那（白）
	iɔ
tɕiɔ	①家加嘉傢稼佳②夹裌甲挟③假贾④架驾嫁价
tɕʰiɔ	①掐（～脖子）②洽恰掐④跨（白）
ɕiɔ	①蝦②霞狭瞎④夏下
ʑiɔ	①丫鸦桠挜（～饭)②牙芽衙鸭押压③雅哑④亚
	uɔ
kuɔ	①瓜②刮括聒掴③寡剐④掛褂卦
kʰuɔ	①夸③垮胯④跨（文）
xuɔ	①花②华铧划（～船)桦滑猾④化画话划（计～)
uɔ	①蛙挖②娃哇③瓦搲④窪鸹
tʃuɔ	①抓②膼③爪
ʃuɔ	②刷③耍
	o
po	①波玻②缽拨博薄（厚～）剥缚驳③簸④播薄（～荷）
pʰo	①坡②婆泼③颇剖④破
mo	①摸摩(～登)②魔磨(～刀)模（～范)末沫③抹④磨（石～）幕慕墓募
to	①多哆②戳夺剟沰（雨淋)③朵躲④剁驮（马～子）惰
tʰo	①拖②驼驮脱托托拓坨舵③妥椭
no	①喏（睡～～）②挪诺④糯摞
lo	①啰②罗椤箩骡螺落(～下)烙(～铁)洛乐（快～）③裸
tso	②撮凿昨桌卓琢着镯③左佐④坐做座
tsʰo	①搓初(～ー)②矬撮④锉措错
so	①唆梭蓑②说索勺芍朔（初一）③锁琐所
zo	②若弱
ko	①哥歌锅②合（十～一升）鸽割葛各阁搁郭廓角箇(～旧市)③果裹④过个
kʰo	①科颗棵②磕壳渴阔③可④课嗑（～瓜子)
xo	①喝②河何荷和合盒豁活郝鹤霍藿③火伙④贺货祸
ɣo	①阿(～胶)窝屙倭②蛾鹅俄恶（凶～）握③我④饿卧
	io
nio	②虐略疟
lio	②掠
tɕio	②嚼爵脚觉（～得）角（两～钱）
tɕʰio	②却雀鹊确
ɕio	②学削
ʑio	②约岳钥药乐（音～）
	ɘɨ
pɘɨ	①杯碑悲背（～人)②北百柏伯白帛③把（介词：～门关好）④倍辈背（脊～)焙臂婢
pʰɘɨ	②培陪赔迫拍魄④配佩沛
mɘɨ	②梅媒煤墨默陌麦脉眉（画～）③美每④妹媚昧
fɘɨ	①非飞妃②肥③匪翡④费废肺吠费痱(～子)
vɘɨ	②微唯惟维③尾④未味
tɘɨ	①他（白）②得德
tʰɘɨ	②特
nɘɨ	③哪（～个）
lɘɨ	②勒肋
tsɘɨ	①遮②窄贼则责宅摘③者④这（文）
tsʰɘɨ	①车②拆册策择泽③扯
sɘɨ	①奢赊②色塞佘蛇③捨舍④社射麝舍赦
zɘɨ	②热③惹
kɘɨ	②格革隔格③曷（～去？）给④锯（白）
kʰɘɨ	②克客刻咳乞（白）④去（白）
xɘɨ	①嘿②黑赫核（～对）
ɣɘɨ	②额呃扼轭
	uɘɨ
tuɘɨ	①堆④队对
tʰuɘɨ	①推②颓③腿④退褪
nuɘɨ	④内
luei	①鐳②雷擂③吕累（积～）垒儡屡④累（劳～）泪类
kuɘɨ	①龟规归闺②国③鬼轨诡癸④桂跪贵柜
kʰuɘɨ	①亏盔魁②逵奎葵③傀④愧溃（～败)
xuɘɨ	①灰恢挥辉徽②回茴或惑③悔毁④汇会(～议)惠慧溃(～脓)晦（灾星～气）讳贿
uɘɨ	①威煨萎巍②危为（作～)违围③委伟苇④卫畏喂为（～什么)位魏慰伪胃谓
tʃuɘɨ	①追锥③嘴④罪醉赘坠
t̠ʃʰuɘɨ	①崔催吹炊摧②垂锤④脆翠
ʃuɘɨ	①尿虽绥②随谁③水④碎岁税睡瑞穗隧
ʒuɘɨ	③蕊④锐
	ɘ˞
pɘ˞	①褒
mɘ˞	②谋③某亩牡
fɘ˞	②浮③否
tɘ˞	①兜逗（挑～)③斗（一～米)抖陡④斗（～争)逗豆（～号)鬥（遇）
tʰɘ˞	①偷②投头④透
nɘ˞	④吺（啰嗦）
lɘ˞	①喽②楼③篓搂缕④漏
tsɘ˞	①邹周舟州洲③走肘④奏皱绉咒纣宙昼
tsʰɘ˞	①抽搊(～上去)②绸稠筹愁仇酬③丑瞅④臭湊骤
sɘ˞	①收馊搜飕③手首守④嗽瘦受兽寿授售
zɘ˞	②柔揉
kɘ˞	①勾沟钩③狗苟④够彀（往上～）构购
kʰɘ˞	①抠③口④扣叩
xɘ˞	①齁②候喉猴瘊③吼④候厚后
ɣɘ˞	①欧抠（～黄鳝）瓯（汤缽子）③偶呕藕④沤怄
	iɘ
miɘ	④谬
tiɘ	①丢
niɘ	①妞②牛③纽扭④拗
liɘ	②流刘留硫琉③柳④溜〔～冰)榴（石～）瘤
tɕiɘ	①纠揪鸠③酒九久韭灸（针～）④就旧舅救白柩究
tɕʰiɘ	①秋秋丘煪（烟～）②囚泅求球仇（姓)
ɕiɘ	①修休羞③朽④秀绣锈袖宿（星～)嗅
ʑiɘ	①优悠幽②油由游邮尤③友有④又右祐幼柚釉酉诱
	ã
pã	①班搬扳帮邦斑颁般③板榜绑版④半拌伴办棒扮瓣谤
pʰã	①潘攀肨（肿～）乓②盘旁傍(～边；～晚)螃庞④判叛胖绊攀盼
mã	①䏵②蛮忙瞒馒芒茫③满莽蟒④曼慢漫面（一～走一～说)
fã	①方芳肪翻番蕃②烦繁房防妨凡帆③反纺访仿做④饭贩范犯泛
vã	②亡忘③晚网挽④万望妄
tã	①单(～薄)当(～面)担(～心)丹耽③胆掸党挡④淡担（一～水)旦但弹（子～）蛋当（～作)
tʰã	①贪汤摊滩②弹（～琴)谈痰檀谭堂棠螳唐糖塘③坦躺毯④炭趟烫叹探
nã	②南男难（～处)囊③攮攘④难（灾～)
lã	②兰篮蓝拦栏郎廊狼③懒搅览榄朗④浪晾(～衣裳)烂滥
tsã	①簪沾占(～卜)毡赃脏张章③昝斩盏攒展搌长(～大)涨掌仗（炮～）④战占站暂蘸赞赞颤栈丈仗（打～）杖藏(西～)帐胀瘴障葬
tsʰã	①参(～加)搀仓苍昌菖倡餐②蚕馋缠缠残藏（收～)长（～短)肠场常尝③惨产铲厂④灿唱畅
sã	①山搧桑商伤裳衫删丧③闪散(～乱)伞嗓搡赏偿晌陕④散（解～）善扇膳单（姓）丧(～失)上尚
zã	②燃燃瓤③染壤嚷酿(～酒)④让
kã	①甘柑泔干（～燥)肝竿冈岗纲刚钢缸③感敢橄杆秆擀(～面)赶港④干杠虹
kʰã	①堪康糠鹐（鸡～米）刊勘龛②扛③坎砍慷④看炕抗
xã	①憨鼾夯②含寒函韩行（商～）杭航③喊罕④旱汉汗焊翰项巷陷（～进田头)
ɣã	①安庵鞍肮②昂④按案晏岸揞
	iã
niã	①孃②娘③仰④酿
liã	②良凉量（丈～）梁粱③两④亮谅量（数～)
tɕiã	①江姜将（～要)浆僵疆③蒋奖讲桨④酱匠降(下～)将（大～）犟(～嘴)
tɕʰiã	①枪腔羌②墙强详③抢④呛像
ɕiã	①香乡相箱厢湘镶②降（投～）③想响享④相(～貌)向象
ʑiã	①央秧殃②羊洋杨扬阳疡③养痒④样
	uã
kuã	①光③广④逛
kʰuã	①匡眶筐诓②狂③硄（用力敲门）④况旷矿
xuã	①荒慌塃②黄潢簧蟥皇蝗惶③谎④晃
uã	①汪②王③枉往④旺
tʃuã	①装庄妆④壮状
t̠ʃʰuã	①窗疮②床③闯④创
ʃuã	①双霜③爽
	ɘ˞̃
pɘ˞̃	①奔锛崩③本④笨
pʰɘ˞̃	①烹喷(～水)②盆④喷(～噬)
mɘ˞̃	①闷（闭嘴，～啰嘴）②门们扪④闷（胸～）焖面（～前)
fɘ˞̃	①分芬氛纷盼②焚坟③粉④愤奋分（水～)份
vɘ˞̃	②文蚊纹闻③吻刎④问
tɘ˞̃	①灯登③等戥(～子)④凳瞪镫澄(～清)
tʰɘ˞̃	①熥（把饭～热）②腾藤疼誊
nɘ˞̃	②能
lɘ˞̃	②棱③冷④愣
tsɘ˞̃	①正(～月)征症(～结)贞侦珍诊（～所）针砧（～板)斟甄蒸真曾（姓）增憎争睁③枕诊(～断)疹（麻～）整怎拯④正(～副)政症（～状)振震阵镇郑挣甑赠赈
tsʰɘ˞̃	①称（～呼)抻撑②曾（～经)成城诚程臣陈尘沉层乘（～法）③惩岑（羞）④称（～心)秤趁乘（～车)
sɘ˞̃	①深身申伸呻绅森参（人～)升声生笙性甥僧②神晨承③审婶省④胜圣剩盛(～大)甚肾
zɘ˞̃	①扔②人仁壬任（姓)③刃忍纫韧仍④认任（主～)
kɘ˞̃	①根耕更（打～）庚③埂哽鲠梗④硌更(～好)
kʰɘ˞̃	①吭坑③恳垦肯啃
xɘ˞̃	①亨哼②衡恒痕③很狠④恨
ɣɘ˞̰	①恩④硬
	iɛ
piɛ	①鞭编边③贬扁匾④辨辩辫变便（方～）
pʰiɛ	①篇偏②便(～宜)④骗片遍
miɛ	②棉绵眠③缅免勉④面（对面）
tiɛ	①滇颠掂③点典④店电殿佃垫
tʰiɛ	①天添②田甜填③舔④掭
niɛ	①研（～究）拈（～起来）②年黏③碾辇撚（以指～碎)撵④念
liɛ	②镰帘连怜莲③脸④殓练炼栋（苦～子)恋
tɕiɛ	①监尖兼搛艰间（空～）奸煎肩坚绢捐③减检俭简柬拣剪笕捲④见贱舰鉴间（～断）渐剑件箭饯贱建圈（牛～)卷券倦眷
tɕʰiɛ	①千迁歼笺谦牵圈（圆～)铅间（中～）先（～走）②钱乾(～坤)前全泉拳权钳③浅遗犬潜④嵌欠劝歉
ɕiɛ	①先（～生）鲜仙轩掀宣暄②咸嫌闲贤弦玄旋悬③险显选癣④限线羡陷（攻～）现县宪献
ʑiɛ	①炎醃淹烟渊冤②盐严颜延言圆员缘沿元原源袁园阎檐③掩眼演远魇④验厌艳焰酽雁谚堰燕宴愿怨院
	uɘ˞̃
tuɘ˞̃	①端③短断（～车)④断（折～）段锻缎
tʰuɘ˞̃	②团
nuɘ˞̃	③暖
luɘ˞̃	②鸾栾③卵④乱
kuɘ̃˞	①关官倌棺观冠（衣～)鳏③管馆④贯惯掼灌罐冠(～军)
kʰuɘ˞̃	①宽③款侃（白）
xuɘ˞̃	①欢②环还（归～）③缓④换幻唤焕宦患奂
uɘ˞̃	①弯湾豌②玩完丸③腕皖碗④院（医～）
tʃuɘ˞̃	①专砖钻③转(～动)④钻(～子)转(～圈)传（记～）篆
t̠ʃʰuɘ˞̃	①氽川穿②传（宣～）船椽③喘④串窜篡
ʃuɘ˞̃	①酸栓拴闩②纯④算蒜涮疝
ʒuɘ˞̰	③软阮
	ɨ̃
pɨ̃	①兵宾冰斌彬殡③丙柄饼禀秉④病并併
pʰɨ̃	①拼姘乒②贫平坪评瓶屏萍苹凭频③品④聘
mɨ̃	②民明名冥铭呜盟③敏抿闽悯皿④命
tɨ̃	①丁钉叮盯③顶鼎④定订钉打（白）（～住)锭
tʰɨ̃	①厅汀听（～课)钉(～钯儿)②庭蜒廷亭停婷③挺艇④听(～任)
nɨ̃	②凝吟宁
lɨ̃	①拎②林淋菱凌玲铃临邻鳞燐灵宁③领岭檩凛④另令吝赁
tsɨ̃	①金津巾筋均君军京惊经晶浸侵襟③紧锦仅谨境景警颈④禁尽进晋近劲俊菌郡敬竞镜競净静
tsʰɨ̃	①亲(～人)轻青蜻清钦卿②琴禽秦勤芹群裙琼③请倾顷④庆亲（～家)磬
sɨ̃	①心辛新薪欣熏勋兴(～旺)星腥馨②形刑型寻旬荀巡行(～为)循③醒寝擤(～鼻子)④信训幸兴（高～）迅衅囟(～门儿)
zɨ̃	①音阴荫因姻洇（纸～）蝇鹰殷樱鹦婴英②淫银寅云匀迎盈赢营萤③饮引隐允尹颖影④印韵运晕熨应孕映泳詠
	õ
põ	①绷④蹦蚌泵
pʰõ	①埄②朋鹏棚蓬篷③捧④碰
mõ	①蒙（～一层纸）②蒙檬濛③懵猛蜢④梦孟
fõ	①风枫疯丰封峰锋蜂②逢缝(～衣裳)冯③讽④凤奉俸缝（门～）
tõ	①敦墩蹲东冬③董懂趸(～来卖)④动栋冻洞顿盾沌（混～）
tʰõ	①通吞②屯囤同铜桐筒童彤③桶统捅④痛褪蜕（蛇～皮）
nõ	②农浓脓④嫩
lõ	①聋咙②龙笼伦轮隆③拢垄陇④论弄
tsõ	①尊遵宗综棕中忠盅钟衷终③准总肿种④中仲纵纵众粽重种
tsʰõ	①冲充春村春椿皴聪葱囱②存从丛虫崇重③蠢宠④寸冲
sõ	①松孙嵩②倯③损笋榫髓（骨～）怂④顺送颂诵讼舜
zõ	②绒冗戎茸④润闰
kõ	①公蚣工攻弓躬官恭供③滚汞拱巩䂵④棍贡共供
kʰõ	①昆坤空③捆孔恐④空困睏控
xõ	①昏婚烘轰荤②魂浑横洪红鸿宏③哄④混
ɣõ	①温瘟翁嗡③稳④瓮
	iõ
tɕʰiõ	②穷
ɕiõ	①胸凶兄匈②熊雄
ʑiõ	①庸雍臃②荣容蓉熔③永勇拥俑恿④用佣
ɣɯ˞	②儿而③耳尔④二
